@--S--+     K-----E
      |     |     |
N-----+     |     |
|           |     |
+-----A-----+     x