     @
  ++ ++   xT
  |+--+ ++ |
  +----C+| |
 +----+  O C
 P--+ +-M+ |
    A--+  ++
       +--+